┌─────────────────────────────────────────────────┐
│^^^```````````````````````````^```````````^``````│
│^^`+````````````````````~~~```^```~+~`````^``````│
│^^````````````````````~~~`````^````~~~`````````+`│
│^`````````````````````````````^`==``@``==````````│┌─────┐
│````~~~```````````````````````^```````````^``````││`````│
│````~~~```````````````````````^```````````^``````└┘`````│
│``+~~~~```````````````^^``````^^^^^###^^^^^`````````````│
│`````~~~`````````````^^^^`````^```+```````^``````┌┐`````│
│`````~~~~``````````````^^^^```^```````````^``````││`````│
│```````~``````````````````````^```````````^``````│└─────┘
│`````````*``````````````+``==`^```````````^``````│
│``````````````````````````````^```````````^``````│
│^^^^^^^^^^^^```````^^^^^^^^^^^^```````====^``--``│
│```````````````+`````````````````````=^===^------│
│``````````````````````~~~~~``````````=^^^^^------│
│`````````````````````~~~!~~~`````````=^===^------│
│``````````````````````~~~~~``````````=^===^------│
└─────────────────────────────────────────────────┘
: