┌─────────────────────────────────────────────────┐
│^^^```````````````````````````^```````````^``````│
│^^`+````````````````````~~~```^```~~~`````^``````│
│^^````````````````````~~~`````^````~~~```````````[
│^`````````````````````````````^`==``@``==````````│
│````~~~```````````````````````^```````````^``````│
│````~~~```````````````````````^```````````^``````│
│``+~~~~```````````````^^``````^^^^^###^^^^^``````│
│`````~~~`````````````^^^^`````^```+```````^``````│
│`````~~~~``````````````^^^^```^```````````^``````│
│```````~``````````````````````^```````````^``````│
│`````````*``````````````+``==`^```````````^``````│
│``````````````````````````````^```````````^``````│
│^^^^^^^^^^^^```````^^^^^^^^^^^^```````====^``````│
│```````````````+`````````````````````=^===^``--``│
│``````````````````````~~~~~``````````=^^^^^`----`│
│`````````````````````~~~!~~~`````````=^===^------│
│``````````````````````~~~~~``````````=^===^``````│
└─────────────────────────────────────────────────┘
: