┌───────────────────────────────┐
│^^^```````````````````````````^│
│^^`+```*````````````````~~~```^│
│^^```*````````````````~~~`````^│
│^`````````````````````````````^│
│````~~~```````````````*```````^│
│````~~~```````````````````````^│
│+++~~~~```````````````^^``````^│
│````*~~~`````````````^^^^`````^│
│`````~~~~``````````````^^^^```^│
│```````~``````````````````````^│
│```````````*``````````````+```^│
│``````````````````````````````^│
└───────────────────────────────┘