┌─────────────────────────────────────────────────┐
│^^^```````````````````````````^```````````^``````│
│^^`+````````````````````~~~```^```~+~`````^``````│
│^^````````````````````~~~`````^````~~~`````````+`│
│^`````````````````````````````^`==``@``==````````│┌─────┐
│````~~~```````````````````````^```````````^``````││`````│
│````~~~```````````````````````^```````````^``````└┘`````│
│``+~~~~```````````````^^``````^^^^^###^^^^^`````````````│
│`````~~~`````````````^^^^`````^```+```````^``````┌┐`````│
│`````~~~~``````````````^^^^```^```````````^``````││`````│
│```````~``````````````````````^```````````^``````│└─────┘
│`````````*``````````````+``==`^```````````^``````│
│``````````````````````````````^```````````^``````│
│^^^^^^^^^^^^```````^^^^^^^^^^^^```````====^``````│
│```````````````+`````````````````````=^===^``--``│
│``````````````````````~~~~~``````````=^^^^^`----`│
│`````````````````````~~~!~~~`````````=^===^------│
│``````````````````````~~~~~``````````=^===^``````│
└─────────────────────────────────────────────────┘
: