┌───────────────────────────────┐
│^^^```````````````````````````^│
│^^`+````````````````````~~~```^│
│^^````````````````````~~~`````^│
│^`````````````````````````````^│
│````~~~```````````````````````^│
│````~~~```````````````````````^│
│``+~~~~```````````````^^``````^│
│`````~~~`````````````^^^^`````^│
│`````~~~~``````````````^^^^```^│
│```````~``````````````````````^│
│```````````*``````````````+```^│
│``````````````````````````````^│
│^^^^^^^^^^^^```````^^^^^^^^^^^^│
│```````````````+```````````````│
│``````````````````````~~~~~````│
│`````````````````````~~~!~~~```│
│``````````````````````~~~~~````│
└───────────────────────────────┘