┌─────────────────────────────────────────────────┐
│^^^```````````````````````````^```````````^``````│
│^^`+````````````````````~~~```^```~~~`````^``````│
│^^````````````````````~~~`````^````~~~```````````│
│^`````````````````````````````^`````@````````````│
│````~~~```````````````````````^```````````^``````│
│````~~~```````````````````````^```````````^``````│
│``+~~~~```````````````^^``````^^^^^###^^^^^``````│
│`````~~~`````````````^^^^`````^```+```````^``````│
│`````~~~~``````````````^^^^```^```````````^``````│
│```````~``````````````````````^```````````^``````│
│```````````*``````````````+```^```````````^``````│
│``````````````````````````````^```````````^``````│
│^^^^^^^^^^^^```````^^^^^^^^^^^^```````````^``````│
│```````````````+``````````````````````^^``^``--``│
│``````````````````````~~~~~```````````^^^^^`----`│
│`````````````````````~~~!~~~``````````^~~~^------│
│``````````````````````~~~~~```````````^~~~^``````│
└─────────────────────────────────────────────────┘
: