┌──────────────────────────────────────┐
│^^^```````````````````````````^```````│
│^^`+````````````````````~~~```^```~~~`│
│^^````````````````````~~~`````^````~~~│
│^`````````````````````````````^```````│
│````~~~```````````````````````^```````│
│````~~~```````````````````````^```````│
│``+~~~~```````````````^^``````^```````│
│`````~~~`````````````^^^^`````^```+```│
│`````~~~~``````````````^^^^```^```````│
│```````~``````````````````````^```````│
│```````````*``````````````+```^```````│
│``````````````````````````````^```````│
│^^^^^^^^^^^^```````^^^^^^^^^^^^```````│
│```````````````+``````````````````````│
│``````````````````````~~~~~```````````│
│`````````````````````~~~!~~~``````````│
│``````````````````````~~~~~```````````│
└──────────────────────────────────────┘
: