┌──────────────────────────────────────────┐
│^^^```````````````````````````^```````````│
│^^`+````````````````````~~~```^```~~~`````│
│^^````````````````````~~~`````^````~~~````│
│^`````````````````````````````^`````@`````│
│````~~~```````````````````````^```````````│
│````~~~```````````````````````^```````````│
│``+~~~~```````````````^^``````^^^^^###^^^^│
│`````~~~`````````````^^^^`````^```+```````│
│`````~~~~``````````````^^^^```^```````````│
│```````~``````````````````````^```````````│
│```````````*``````````````+```^```````````│
│``````````````````````````````^```````````│
│^^^^^^^^^^^^```````^^^^^^^^^^^^```````````│
│```````````````+``````````````````````^^``│
│``````````````````````~~~~~```````````^^^^│
│`````````````````````~~~!~~~``````````^^^`│
│``````````````````````~~~~~```````````^^^`│
└──────────────────────────────────────────┘
: